R 640 480
NO ./pics/bramble.xpm
EA ./pics/bramble.xpm
SO ./pics/bramble.xpm
WE ./pics/bramble.xpm

S ./pics/barrel.xpm
F ./pics/kusa.xpm
C ./pics/bluestone.xpm





 1111111111111111111
 1003000311303000001
 1311110311030301231 1111111111111111
 1003390111000001001 10033333333333311
1101111000000N041321110033333333333331
13031 13111111111000900033333333333331
13031 10030011111231110033333333333331
11011110111030300001 10033333333333311
 10030001 1303030401 1111111111111111
 10111111 1011111101
 101      1003333001
11911     1000000001
10001     1001001021
14441     1000330001
11111     1000330001
          1001001001
          1304004031
          1003003001
          1111111111
