R 540 460
NO ./images/kita.xpm
SO ./images/minami.xpm
WE ./images/nishi.xpm
EA ./images/higashi.xpm

S ./images/eagle.xpm
F 220,10,0
C 225,30,0




        1111111111111111111111111
        1000000000110000000000001
        1011000001110000002000001
        1001000000000000000000001
111111111011000001110000000000001
100000000011000001110111111111111
111101111111110101000000102011111
111101111111110100012100100011111
110000001101010111000000100011111
100020000000000011002000102011111
100000000000000011210100000011111
11000001110101011111011110N011111
11110111 1110101 1011110100011111
11111111 1111111 1111111111111111


