R 636 120
NO ./images/kita.xpm
EA ./images/higashi.xpm
SO ./images/minami.xpm
WE ./images/nishi.xpm

S ./images/eagle.xpm
F 170,140,120
C 180,200,220

        1111
        1001
        1001
11111111100111111111
10000000000000000001
1001111110S111111001
10011111100111111001
10000000000000000001
11111111122111111111
        1001
        1001
        1001
        1001
        1111
